//MAP CONVERTED BY dmm2tgm.py THIS HEADER COMMENT PREVENTS RECONVERSION, DO NOT REMOVE
"a" = (
/turf/closed/indestructible/reinforced,
/area/facility_hallway/extraction)
"e" = (
/obj/machinery/door/airlock/public/glass{
	hackProof = 1;
	max_integrity = 250000000;
	name = "Extraction Backroom";
	normal_integrity = 250000000;
	req_access_txt = "41";
	whitelist_door = 1
	},
/turf/open/floor/wood,
/area/facility_hallway/extraction)
"f" = (
/obj/structure/chair/comfy/black{
	dir = 4
	},
/turf/open/floor/wood,
/area/facility_hallway/extraction)
"i" = (
/obj/effect/landmark/custom_office/poster,
/turf/closed/indestructible/reinforced,
/area/facility_hallway/extraction)
"j" = (
/obj/structure/table/wood/fancy/black,
/turf/open/floor/wood,
/area/facility_hallway/extraction)
"m" = (
/obj/effect/landmark/custom_office/crate,
/turf/closed/indestructible/reinforced,
/area/facility_hallway/extraction)
"p" = (
/obj/machinery/vending/boozeomat,
/turf/closed/indestructible/reinforced,
/area/facility_hallway/extraction)
"P" = (
/obj/item/bedsheet/cosmos,
/obj/structure/curtain/cloth/fancy,
/obj/structure/bed,
/turf/open/floor/wood,
/area/facility_hallway/extraction)
"T" = (
/turf/open/floor/wood,
/area/facility_hallway/extraction)
"X" = (
/obj/structure/chair/comfy/black{
	dir = 8
	},
/turf/open/floor/wood,
/area/facility_hallway/extraction)

(1,1,1) = {"
a
a
e
a
a
"}
(2,1,1) = {"
i
T
T
f
a
"}
(3,1,1) = {"
m
T
T
j
a
"}
(4,1,1) = {"
i
T
P
X
a
"}
(5,1,1) = {"
a
p
a
a
a
"}
